1,1,1,1,1,1,1,1,1,1,1,1,1,1,1,1
1,0,0,0,0,0,0,0,0,0,0,0,0,0,0,1
1,0,0,0,0,0,0,0,0,0,0,0,0,0,0,1
1,0,0,0,0,0,0,0,0,0,0,0,0,0,0,1
1,0,0,0,0,0,0,0,0,0,0,0,0,0,0,1
1,0,0,0,0,0,0,0,0,0,0,M,2,2,2,1
1,0,0,0,0,0,0,0,0,0,0,M,D,D,D,1
1,0,M,M,M,M,M,1,M,M,M,1,2,2,2,1
1,1,M,M,1,0,0,0,0,0,0,0,0,0,0,1
1,1,M,0,M,M,M,M,M,M,M,M,M,M,M,1
1,2,2,2,2,2,2,2,2,2,2,2,2,2,2,1
1,1,1,1,1,1,1,1,1,1,1,1,1,1,1,1
