1,1,1,1,1,1,1,1,1,1,1,1,1,1,1,1
1,0,0,0,0,0,0,0,0,0,0,0,0,0,0,1
1,0,0,0,0,0,0,0,0,0,0,0,0,0,0,1
1,0,0,M,M,M,M,M,M,M,M,M,M,M,M,1
1,0,0,0,0,0,0,0,0,0,0,0,0,0,0,1
1,0,0,0,0,0,0,0,0,0,0,0,2,2,2,1
1,0,0,0,0,0,0,0,0,1,0,0,D,D,D,1
1,0,0,0,0,0,0,1,0,0,0,1,2,2,2,1
1,1,0,0,1,0,0,0,0,0,0,0,0,0,0,1
1,1,M,M,M,M,M,M,M,M,M,M,M,M,M,1
1,2,2,2,2,2,2,2,2,2,2,2,2,2,2,1
1,1,1,1,1,1,1,1,1,1,1,1,1,1,1,1
